10 10
1 1
10 10
2 1 8 1 1 2 4 7 8 X
3 1 1 5 1 5 1 5 8 8
4 2 2 2 1 6 1 4 6 7
8 5 1 7 0 3 5 1 1 6
3 7 8 1 2 6 8 1 5 1
2 7 4 1 1 4 2 2 4 2
6 5 1 2 1 2 7 5 1 6
7 7 1 3 4 2 0 4 2 1
8 8 1 1 1 5 1 1 9 1
X 8 7 1 3 1 7 1 0 0
